0,14,3,3,3,3,3,3,14,0
0,18,3,3,3,3,3,3,18,0
0,18,3,3,3,3,3,3,18,0
0,18,3,3,3,3,3,3,18,0
0,17,3,4,3,4,3,7,6,0
0,0,0,0,0,0,0,0,0,0
0,0,0,0,0,0,2,0,0,0
0,0,2,0,0,0,0,0,0,0
0,0,0,0,0,0,0,0,0,0
0,0,0,0,0,0,0,0,0,0