3,3,18,19,19,19,19,18,3,3
3,3,18,19,19,19,19,18,3,3
9,9,6,19,19,19,19,5,9,9
19,19,19,19,19,19,19,19,19,19
19,19,19,19,15,16,19,19,19,19
19,19,19,19,5,6,19,19,19,19
19,19,19,19,19,19,19,19,19,19
9,9,16,19,19,19,19,15,9,9
3,3,18,19,19,19,19,18,3,3
3,3,18,19,19,19,19,18,3,3