25,25,25,19,19,19,19,25,25,25
24,24,24,19,19,19,19,24,24,24
28,28,28,19,19,19,19,27,27,27
19,19,19,19,19,19,19,19,19,19
19,19,19,19,20,21,19,19,19,19
19,19,19,19,22,23,19,19,19,19
19,19,19,19,19,19,19,19,19,19
26,26,26,19,19,19,19,26,26,26
25,25,25,19,19,19,19,25,25,25
24,24,24,19,19,19,19,24,24,24