3,3,3,3,18,19,19,19,19,19
3,3,3,3,18,19,19,19,19,19
3,3,3,3,5,9,9,9,9,9
3,3,3,3,3,3,3,3,3,3
3,3,3,3,3,3,3,3,3,3
3,3,3,3,3,3,3,3,3,3
3,3,3,3,3,3,3,3,3,3
3,3,3,3,15,9,9,9,9,9
3,3,3,3,18,19,19,19,19,19
3,3,3,3,18,19,19,19,19,19